Carlos.............000000039150
Andrés.............000000038250
Andres.............000000036500
Andres.............000000035550
Andrés.............000000033250
Andrés.............000000029250
Andrés.............000000027450
____________.......000000000000
____________.......000000000000
____________.......000000000000
